1111111111111111111111111111111
10P000000100C000000000X00100001
11100000011100000C000000000EX01
1000000000000111C0000C000111111
1111110001000111111100000100101
100000000100C000X00000X00111101
10X1111C000X000C001110000000001
1111111111111111111111111111111