1111111111111
1X000100000P1
1000001111001
10000000C0001
10C0000000001
10000000C0011
1C011E0000001
1111111111111