1111111111
10000C0001
1P000d00E1
1111111111