1111111111111
1X000100000P1
1000001111001
1000X000C0001
10000000000X1
10000000C0011
10011E0000X01
1111111111111